100000,"MOBIL PERMAZONE, 19LT",0,0,3,1,2,0,6,16,0,0,184674,61558,123000,0,369232,984812
100002,"MOBIL PERMAZONE 50%, 208LT",0,0,0,1,1,0,2,4,0,0,0,437922,437922,0,875844,1751688
100007,MOBIL MINING COOLANT 50% 19 LT,0,2,9,2,9,0,22,23,0,116330,523485,116330,495000,0,1251145,1309310
100008,"MOBIL MINING COOLANT 50%, 208LT",0,0,0,1,1,0,2,3,0,0,0,545273,545273,0,1090546,1635819
100018,"MOBIL PERMAZONE READY TO USE, 1LT",0,0,0,0,0,0,0,3,0,0,0,0,0,0,0,108483
100019,"MOBIL PERMAZONE 50%, 19LT",5,4,3,2,2,1,17,41,244300,195440,146580,97720,97720,48868,830628,2043845
100050,"MOBIL BRAKE FLUID DOT-4, 1LT",0,0,0,0,0,2,2,2,0,0,0,0,0,118908,118908,118908
100052,"MOBIL BRAKE FLUID DOT-4, 19LT",0,0,0,0,0,0,0,1,0,0,0,0,0,0,0,91318
100057,"MOBIL HD 40, 208LT",1,0,0,1,0,0,2,16,520000,0,0,500684,0,0,1020684,8060472
100058,"MOBIL SUPER 2T, 1LT",0,0,0,0,1,0,1,4,0,0,0,0,37110,0,37110,148440
100059,"MOBIL SUPER 2T, 1/2LT",0,0,0,0,0,1,1,11,0,0,0,0,0,37110,37110,408200
100060,"MOBIL SUPER 2T, 19LT",1,0,0,0,0,0,1,1,59007,0,0,0,0,0,59007,59007
100072,"MOBIL SPECIAL 2T, 19LT",0,0,0,2,0,0,2,2,0,0,0,118110,0,0,118110,118110
100073,"MOBIL SPECIAL 2T, 208LT",0,1,0,0,0,0,1,1,0,535800,0,0,0,0,535800,535800
100077,"MOBIL DELVAC SUPER 20W-50, 19LT",0,3,0,1,1,0,5,9,0,167199,0,55733,59714,0,282646,560618
100078,"MOBIL DELVAC SUPER 20W-50, 208LT",1,1,1,0,0,0,3,4,527500,527500,527500,0,0,0,1582500,2210833
100106,"MOBIL DELVAC 1350, 19LT",0,0,0,0,0,0,0,2,0,0,0,0,0,0,0,176390
100122,"MOBIL DELVAC MX 15W-40, 19LT",14,11,11,12,12,0,60,69,885000,703665,660000,720000,720000,0,3688665,4345105
100124,"MOBIL DELVAC MX 15W-40, 208LT",2,4,5,3,3,0,17,20,1000000,2075000,2616250,1566250,1575000,0,8832500,10713418
100210,"MOBILUBE HD PLUS 80W-90, 1LT",0,1,0,1,0,0,2,7,0,46667,0,46667,0,0,93334,347919
100212,"MOBILUBE HD PLUS 80W-90, 19LT",2,6,6,1,4,1,20,59,120246,361615,360660,61000,252282,61000,1216803,3858208
100214,"MOBILUBE HD PLUS 80W-90, 208LT",2,0,0,0,0,0,2,3,1109596,0,0,0,0,0,1109596,1717692
100223,"MOBILUBE HD PLUS 85W-140, 19LT",1,6,3,0,1,0,11,19,72068,432402,216201,0,72067,0,792738,1369063
100225,"MOBILUBE HD PLUS 85W-140, 208LT",0,0,0,0,0,0,0,2,0,0,0,0,0,0,0,1261878
100231,"MOBILTRANS HD 10W, 19LT",0,1,0,0,0,0,1,1,0,71266,0,0,0,0,71266,71266
100234,"MOBILTRANS HD 30, 19LT",1,0,0,0,0,0,1,2,76806,0,0,0,0,0,76806,169613
100280,"MOBIL ATF 220, 1LT",0,0,0,0,0,0,0,5,0,0,0,0,0,0,0,269525
100282,"MOBIL ATF 220, 19LT",0,5,0,2,1,0,8,11,0,350000,0,140000,70000,0,560000,776444
100284,"MOBIL ATF 220, 208LT",2,0,0,0,0,0,2,2,1195200,0,0,0,0,0,1195200,1195200
100287,"MOBILFLUID 424, 19LT",2,2,1,5,4,0,14,15,123062,123631,61531,307655,246124,0,862003,932171
100289,"MOBILFLUID 424, 208LT",0,0,2,0,0,0,2,9,0,0,1141202,0,0,0,1141202,5390356
100317,"MOBILGREASE MP, 1/2KG",1,0,0,0,0,0,1,3,65951,0,0,0,0,0,65951,225333
100320,"MOBILGREASE MP, 181KG",0,0,0,0,1,0,1,1,0,0,0,0,774017,0,774017,774017
100322,"MOBILGREASE SPECIAL, 16KG",0,1,3,0,2,0,6,9,0,122191,366573,0,244382,0,733146,1167604
100331,"MOBILGREASE XHP 222, 400GR",2,11,2,23,13,2,53,95,77726,427535,77726,894528,520000,79000,2076515,3677224
100332,"MOBILGREASE XHP 222, 16KG",1,8,5,14,0,0,28,53,102861,822888,514305,1467861,0,0,2907915,5565160
100334,"MOBILGREASE XHP 222, 181KG",0,0,0,0,0,0,0,1,0,0,0,0,0,0,0,1042722
100347,"MOBIL ALMO 527, 19LT",0,1,0,0,0,0,1,1,0,74646,0,0,0,0,74646,74646
100348,"MOBIL ALMO 527, 208LT",0,0,0,0,0,0,0,2,0,0,0,0,0,0,0,1549340
100351,"MOBIL ALMO 532, 19LT",0,0,0,0,2,0,2,7,0,0,0,0,149292,0,149292,600277
100365,"MOBILGREASE 28, 4,4LB",0,0,0,0,1,0,1,1,0,0,0,0,318558,0,318558,318558
100380,"MOBIL DTE OIL LIGHT, 208LT",0,0,0,2,0,0,2,2,0,0,0,1513030,0,0,1513030,1513030
100381,"MOBIL DTE OIL MEDIUM, 19LT",0,0,0,0,1,0,1,1,0,0,0,0,84675,0,84675,84675
100383,"MOBIL DTE OIL HEAVY MEDIUM, 19LT",0,2,1,1,0,0,4,6,0,164612,82306,82306,0,0,329224,528130
100387,"MOBIL DTE OIL HEAVY, 208LT",0,1,0,0,0,0,1,4,0,805007,0,0,0,0,805007,3584198
100388,"MOBIL DTE OIL EXTRA HEAVY, 19LT",0,0,1,5,0,0,6,20,0,0,95121,492450,0,0,587571,2196689
100391,"MOBIL DTE OIL BB, 19LT",0,0,0,1,0,0,1,1,0,0,0,89600,0,0,89600,89600
100392,"MOBIL DTE OIL BB, 208LT",0,0,0,0,0,0,0,1,0,0,0,0,0,0,0,917153
100395,"MOBIL VACTRA OIL N° 2, 19LT",1,2,8,8,7,0,26,37,95231,167234,668930,669682,587930,0,2189007,3294345
100396,"MOBIL VACTRA OIL N° 2, 208LT",0,0,1,1,0,1,3,5,0,0,734085,734085,0,734085,2202255,3891815
100397,"MOBIL VACTRA OIL N° 4, 19LT",0,0,1,1,0,0,2,8,0,0,83617,83617,0,0,167234,773462
100398,"MOBIL VACTRA OIL N° 4, 208LT",0,1,0,0,0,0,1,2,0,834000,0,0,0,0,834000,1678780
100408,"MOBIL 600W CYLINDER OIL, 19LT",0,0,0,1,0,0,1,1,0,0,0,79000,0,0,79000,79000
100420,"MOBIL DTE 24, 208LT",0,0,0,0,0,0,0,2,0,0,0,0,0,0,0,1432704
100448,"MOBIL SHC 634, 19LT",0,0,0,0,0,0,0,2,0,0,0,0,0,0,0,573901
100452,"MOBIL SHC 626, 19LT",0,0,1,0,0,0,1,3,0,0,225055,0,0,0,225055,702609
100454,"MOBIL SHC 629, 19LT",0,0,0,0,3,0,3,4,0,0,0,0,813000,0,813000,1098288
100457,"MOBIL SHC 630, 208LT",0,0,1,0,0,0,1,1,0,0,2545060,0,0,0,2545060,2545060
100462,"MOBIL SHC 627, 19LT",0,0,0,0,0,0,0,1,0,0,0,0,0,0,0,246489
100471,"MOBIL ALMO 525, 19LT",0,0,0,1,0,0,1,1,0,0,0,74646,0,0,74646,74646
100482,"MOBIL GLYGOYLE 30, 20LT",3,5,0,7,0,0,15,21,1015188,1691980,0,2368772,0,0,5075940,7230124
100520,"MOBIL RARUS 425, 19LT",0,0,5,2,2,0,9,9,0,0,323535,129414,129414,0,582363,582363
100547,"MOBIL GARGOYLE ARCTIC SHC 226, 19LT",0,0,2,0,0,0,2,2,0,0,411288,0,0,0,411288,411288
100548,"MOBIL GARGOYLE ARCTIC SHC 226, 208LT",0,0,0,0,0,0,0,1,0,0,0,0,0,0,0,2018220
100552,"MOBIL GARGOYLE ARCTIC OIL 300, 208LT",0,0,0,0,2,2,4,4,0,0,0,0,1983491,1930000,3913491,3913491
100560,"MOBILGARD 312, 208LT",0,0,0,1,0,0,1,1,0,0,0,576181,0,0,576181,576181
100640,"MOBILTAC 325 NC, 17KG",0,0,0,0,0,0,0,0,0,0,0,0,0,0,0,0
100684,"MOBILTHERM 605, 208LT",2,0,2,0,0,0,4,5,1294347,0,1234345,0,0,0,2528692,3238930
100696,"MOBILUX EP 023, 16KG",0,0,0,0,1,0,1,1,0,0,0,0,87167,0,87167,87167
100700,"MOBILUX EP 2, 16KG",6,6,10,16,5,3,46,127,488868,488868,814780,1249912,410000,246000,3698428,10200674
100701,"MOBILUX EP 2, 54KG",0,0,0,0,0,0,0,1,0,0,0,0,0,0,0,295262
100702,"MOBILUX EP 2, 181KG",0,0,1,0,0,0,1,2,0,0,824028,0,0,0,824028,1648056
100703,"MOBILUX EP 1, 16KG",0,0,0,0,3,0,3,8,0,0,0,0,277812,0,277812,837297
100706,"MOBILUX EP 0, 16KG",0,0,0,1,0,0,1,4,0,0,0,96200,0,0,96200,444998
100724,"MOBILITH SHC 460, 16KG",0,0,1,0,0,0,1,1,0,0,313555,0,0,0,313555,313555
100727,"MOBILITH SHC 460, 174KG",0,0,1,0,0,0,1,2,0,0,2787116,0,0,0,2787116,5710312
100729,"MOBILITH SHC 007, 16KG",0,0,0,0,2,0,2,2,0,0,0,0,660104,0,660104,660104
100731,"MOBILITH SHC 220, 16KG",0,0,0,0,0,0,0,1,0,0,0,0,0,0,0,350177
100732,"MOBILITH SHC 220, 174KG",0,0,0,0,0,0,0,1,0,0,0,0,0,0,0,3077046
100751,"MOBIL POLYREX EM, 16KG",0,0,0,0,4,0,4,9,0,0,0,0,1080000,0,1080000,2692967
100758,"MOBIL POLYREX EP 2, 16KG",0,0,0,0,3,0,3,29,0,0,0,0,671838,0,671838,7707470
100759,"MOBIL POLYREX EP 2, 180KG",0,1,0,0,1,0,2,3,0,2297000,0,0,2227994,0,4524994,7088956
100778,"MOBIL MAGNOLIA DRILL COMPOUND, 16KG",3,0,0,7,0,0,10,33,580083,0,0,1159102,0,0,1739185,6291360
100796,"MOBILARMA 798, 19LT",0,0,1,0,0,0,1,1,0,0,192464,0,0,0,192464,192464
100798,"MOBIL SOLVAC 1535 G, 19LT",1,11,2,0,1,0,15,16,128293,994323,225294,0,112647,0,1460557,1596673
100799,"MOBIL SOLVAC 1535 G, 208LT",0,0,1,1,2,0,4,5,0,0,994326,994326,1988653,0,3977305,5121569
100838,"MOBIL MARCOL N 82,19LT",0,0,0,0,1,0,1,4,0,0,0,0,87000,0,87000,448757
100840,"MOBIL MARCOL N 82, 212LT",1,0,0,1,0,0,2,2,1081477,0,0,895490,0,0,1976967,1976967
100983,"MOBIL NUTO H 32, 19LT",19,10,20,1,5,0,55,119,919855,439492,879420,43971,219900,0,2502638,5702217
100985,"MOBIL NUTO H 32, 208LT",2,3,2,5,3,4,19,31,798000,1197000,797888,1745048,1159000,1520064,7217000,12101936
100986,"MOBIL NUTO H 68, 19LT",12,17,5,3,22,12,71,140,545739,748525,219663,131850,967032,528870,3141679,6606679
100988,"MOBIL NUTO H 68, 208LT",4,2,8,12,16,0,42,84,1616848,785000,2918000,4233992,5861994,0,15415834,32354624
100989,"MOBIL NUTO H 100, 19LT",0,1,2,0,4,2,9,25,0,43971,87942,0,175884,90000,397797,1197797
100990,"MOBIL NUTO H 100, 208LT",1,3,2,0,1,0,7,25,385000,1219000,795000,0,380000,0,2779000,10078000
100991,"MOBIL NUTO H 46, 19LT",7,14,5,14,12,0,52,95,307797,615594,219855,615594,527679,0,2286519,4451519
100993,"MOBIL NUTO H 46, 208LT",8,10,8,11,2,1,40,110,3211000,3946848,3075000,3843000,790000,385000,15250848,43714848
101084,"MOBIL FAXAM 22, 208LT",1,0,0,0,1,0,2,3,611724,0,0,0,462463,0,1074187,1685911
101099,"MOBILGEAR 600 XP 68, 19LT",0,0,0,1,0,0,1,2,0,0,0,91500,0,0,91500,189823
101107,"MOBILGEAR 600 XP 150, 19LT",0,0,1,0,0,0,1,1,0,0,78752,0,0,0,78752,78752
101110,"MOBILGEAR 600 XP 220, 19LT",0,0,0,0,1,0,1,1,0,0,0,0,80306,0,80306,80306
101113,"MOBILGEAR 600 XP 320, 19LT",0,0,1,0,0,0,1,1,0,0,55000,0,0,0,55000,55000
101119,"MOBILGEAR 600 XP 680, 19LT",4,0,4,0,7,0,15,16,353768,0,353768,0,619094,0,1326630,1433497
101129,"MOBIL SPARTAN EP 150, 19LT",4,0,1,0,3,0,8,13,308016,0,67613,0,202839,0,578468,1042298
101130,"MOBIL SPARTAN EP 150, 208LT",0,0,0,1,0,0,1,1,0,0,0,622936,0,0,622936,622936
101133,"MOBIL SPARTAN EP 220, 19LT",0,2,1,1,1,0,5,5,0,137822,68911,73833,73833,0,354399,354399
101134,"MOBIL SPARTAN EP 220, 208LT",0,0,1,0,1,0,2,3,0,0,643558,0,643558,0,1287116,2027718
101139,"MOBIL SPARTAN EP 460, 19LT",1,1,0,0,0,0,2,2,71237,71237,0,0,0,0,142474,142474
101195,"MOBIL RARUS 824, 19LT",0,0,0,0,0,3,3,3,0,0,0,0,0,815184,815184,815184
101218,"MOBILGREASE XHP 322 MINE, 16KG",0,1,0,0,0,0,1,1,0,162650,0,0,0,0,162650,162650
101220,"MOBILGREASE XHP 321 MINE, 16KG",0,0,0,1,0,0,1,1,0,0,0,162650,0,0,162650,162650
101228,"MOBIL UNIREX N 2, 16KG",0,0,0,0,0,0,0,2,0,0,0,0,0,0,0,378372
101229,"MOBIL UNIREX N 2, 54KG",0,0,0,0,0,0,0,2,0,0,0,0,0,0,0,1394248
101230,"MOBIL UNIREX N 2, 180KG",0,0,1,0,0,0,1,2,0,0,1779464,0,0,0,1779464,3558928
101232,"MOBILTEMP SHC 100, 18KG",0,0,0,0,0,0,0,4,0,0,0,0,0,0,0,1645332
101524,"MOBILGREASE XHP 221, 16KG",0,0,0,0,0,0,0,2,0,0,0,0,0,0,0,248582
101680,"MOBILGREASE XHP462 MOLY, 16KG",0,0,0,0,5,0,5,9,0,0,0,0,660265,0,660265,1298637
101880,"MOBILTHERM 605, 19LT",4,0,0,8,0,0,12,17,299616,0,0,599232,0,0,898848,1351393
101990,"MOBILGEAR XMP 460, 208LTS",0,0,0,0,0,0,0,1,0,0,0,0,0,0,0,884870
102165,"MOBIL PERMAZONE, 208LT",0,0,0,0,0,0,0,1,0,0,0,0,0,0,0,595478
102213,"MOBIL SPECIAL 20W-50, 19LT",0,0,0,0,0,0,0,1,0,0,0,0,0,0,0,76642
102302,"MOBIL DELVAC 1300 SUPER 15W-40, 208LT",0,0,2,1,0,2,5,7,0,0,1409376,704688,0,1409376,3523440,5063852
102410,"MOBIL EXTRA 4T 10W-40, 1LT",0,0,0,0,0,0,0,1,0,0,0,0,0,0,0,74141
102490,"MOBIL DTE 10 EXCEL 46, 208LT",0,0,0,3,0,0,3,3,0,0,0,2958276,0,0,2958276,2958276
102530,"MOBIL SHC CIBUS 32, 20LT",0,0,0,5,0,0,5,5,0,0,0,2411670,0,0,2411670,2411670
102531,"MOBIL SHC CIBUS 46, 20LT",0,5,0,0,7,0,12,12,0,2411670,0,0,3376338,0,5788008,5788008
102536,"MOBIL SHC CIBUS 220, 20LT",0,1,0,0,0,0,1,1,0,482334,0,0,0,0,482334,482334
102537,"MOBIL SHC CIBUS 320, 20LT",1,0,0,0,0,0,1,1,482334,0,0,0,0,0,482334,482334
102540,"MOBIL DTE 10 EXCEL 32, 208LT",0,0,0,3,0,0,3,3,0,0,0,2715000,0,0,2715000,2715000
102543,"MOBIL DTE 10 EXCEL 32, 19LT",0,0,0,2,0,0,2,2,0,0,0,186798,0,0,186798,186798
102544,"MOBIL DTE 10 EXCEL 46, 19LT",0,0,0,1,0,0,1,2,0,0,0,97636,0,0,97636,215612
102545,"MOBIL DTE 10 EXCEL 68, 19LT",0,0,0,2,0,0,2,2,0,0,0,188000,0,0,188000,188000
102550,"MOBIL DTE 10 EXCEL 15 , 19LT",0,0,0,0,0,0,0,1,0,0,0,0,0,0,0,134443
102680,"MOBILGEAR SHC XMP 320, 19LT",0,1,0,0,0,0,1,2,0,294755,0,0,0,0,294755,607483
102750,"MOBIL EXTRA 4T 10W-40, 208LT",0,1,0,0,0,0,1,1,0,1340992,0,0,0,0,1340992,1340992
102921,"MOBILGEAR XMP 320, 208LT",0,0,0,0,0,0,0,3,0,0,0,0,0,0,0,2847797
102994,"MOBILMET 426, 208 LT",1,1,1,2,1,0,6,9,679182,679182,679182,1358364,679182,0,4075092,6770259
102995,"MOBILMET 426, 19LT",1,0,1,0,1,0,3,6,70962,0,70962,0,71000,0,212924,508600
103094,"MOBIL SHC GEAR 220, 19LT",1,0,1,6,6,0,14,18,264289,0,264291,1585746,1585746,0,3700072,4748112
103095,"MOBIL SHC GEAR 320, 19LT",0,0,0,1,0,0,1,1,0,0,0,267291,0,0,267291,267291
103400,"MOBIL RARUS 427, 208LT",0,1,0,0,0,0,1,2,0,605183,0,0,0,0,605183,1301623
103410,"MOBIL RARUS 427, 19LT",0,0,0,2,-2,0,0,5,0,0,0,157452,-157452,0,0,475635
103490,"MOBIL COOLANT COPEC, 5LT",0,0,0,12,40,0,52,52,0,0,0,230688,768960,0,999648,999648
103601,"MOBIL SUPER 3000 X2 5W-40, 4LT",0,0,0,0,0,0,0,1,0,0,0,0,0,0,0,120870
103606,"MOBIL SPECIAL 10W-40, 208LT",0,0,0,1,0,0,1,1,0,0,0,612000,0,0,612000,612000
103670,"MOBIL BIO CHAIN SAW OIL 68, 200LT",0,1,0,0,0,0,1,3,0,513580,0,0,0,0,513580,1872257
103700,"MOBIL VELOCITE N 6, 19LT",0,1,0,1,1,0,3,4,0,227119,0,227119,227119,0,681357,955793
104041,"MOBILGREASE XHP 223,18 KGS",0,0,0,1,0,0,1,1,0,0,0,160971,0,0,160971,160971
104114,"MOBIL DELVAC ELITE 15W/40, 19LT ",0,0,1,0,0,0,1,1,0,0,98179,0,0,0,98179,98179
104200,"MOBIL  UNIVIS 46, 208LTS",0,1,0,0,0,0,1,2,0,665356,0,0,0,0,665356,1431044
104280,MOBIL SHC RARUS 46 19LT,0,0,0,1,0,0,1,2,0,0,0,306662,0,0,306662,632023
104282,"MOBIL SHC RARUS 68, 19LT ",0,0,1,0,1,0,2,3,0,0,306662,0,306662,0,613324,938685
104323,"MOBIL UNIVIS N 32, 19LT",10,1,0,0,0,0,11,27,808548,71871,0,0,0,0,880419,2234992
104324,"MOBIL UNIVIS N 46, 19 LTS",0,2,1,0,0,0,3,4,0,143076,71538,0,0,0,214614,301055
104331,"MOBIL VACUOLINE 537, 19LT",0,0,0,0,0,0,0,1,0,0,0,0,0,0,0,128279
104342,"MOBIL DELVAC 1 GEAR OIL 75W - 90, 19LT ",0,0,0,0,0,0,0,1,0,0,0,0,0,0,0,261552
104405U,"MOBIL SUPER 3000 XE 5W- 30, BIDON 4 LTS ",0,0,0,0,0,0,0,2,0,0,0,0,0,0,0,66000
104406,"MOBIL SUPER 3000 XE 5W-30, 208LT",1,0,0,0,0,0,1,3,1174717,0,0,0,0,0,1174717,3524151
104711,"MOBIL DELVAC 1 TRANS FLUID 50, 19LT",0,0,3,0,0,0,3,8,0,0,924501,0,0,0,924501,2559286
104740,MOBIL AGUA DESMINERALIZADA 5 LT,0,1,0,0,0,0,1,1,0,11848,0,0,0,0,11848,11848
104780,"MOBIL DELVAC 1 ATF, 19LT ",0,3,0,0,0,0,3,18,0,673683,0,0,0,0,673683,4247298
104811,"MOBIL DELVAC EXTREME 10W-30, 19LT",0,0,0,0,0,0,0,1,0,0,0,0,0,0,0,129237
104901,"MOBILECT 39, 210LT",0,2,0,1,0,0,3,4,0,1442760,0,721201,0,0,2163961,2993915
105190,"MOBIL DELVAC  XHP ESP S 10W-40, 19LT",0,0,0,0,3,0,3,19,0,0,0,0,303189,0,303189,2257212
105223,"MOBIL ATF D/M, 208LT",1,0,0,0,0,0,1,1,906308,0,0,0,0,0,906308,906308
105232,"MOBIL SUPER 2000 FORMULA P 10W-40, 208LTS",2,0,0,2,0,0,4,4,1748250,0,0,1748250,0,0,3496500,3496500
105352,"MOBIL DELVAC 1 ESP 5W-40, 4LT ",0,0,0,0,0,0,0,2,0,0,0,0,0,0,0,504910
105621,"MOBIL SUPER 3000 XE 5W -30, 4LTS",0,0,0,0,0,0,0,20,0,0,0,0,0,0,0,2506080
105621U,"MOBIL SUPER 3000 XE 5W -30, 4LTS",0,0,0,0,0,0,0,12,0,0,0,0,0,0,0,375912
105626,"MOBIL SUPER 2000 FORMULA 9 10W -40, 4LTS ",2,0,2,1,0,0,5,18,158706,0,158706,79353,0,0,396765,1428354
105627,MOBIL SUPER 1000 10W-30 4LT,0,0,2,0,0,0,2,4,0,0,153190,0,0,0,153190,306164
105628,"MOBIL SUPER 1000 20W-50, 4LT",1,0,0,0,0,0,1,1,64852,0,0,0,0,0,64852,64852
105631,"MOBIL SPECIAL 10W-40, 4LT",0,0,0,0,0,0,0,50,0,0,0,0,0,0,0,2550000
105632,"MOBIL SPECIAL 20W 50, 4LT ",0,0,0,0,0,0,0,51,0,0,0,0,0,0,0,2535164
105636,"MOBIL ATF 220, 4LT",0,0,0,0,1,0,1,2,0,0,0,0,66528,0,66528,133056
105638,"MOBIL DELVAC MX 15W-40, 4LT",0,0,0,0,0,0,0,1,0,0,0,0,0,0,0,78607
105638U,"MOBIL DELVAC MX 15W-40, 1 UND X 4LT",0,0,0,15,1,0,16,16,0,0,0,294780,19652,0,314432,314432
105639,"MOBIL DELVAC SUPER 1200 F2 15W-40,4LT",0,0,0,0,0,0,0,50,0,0,0,0,0,0,0,2985000
105642,"MOBILUBE HD PLUS 80W-90, 4LT",0,0,2,0,1,0,3,6,0,0,133560,0,66780,0,200340,399925
105643,"MOBIL DELVAC EXTENDED LIFE C 50%, 4LT",0,0,0,0,0,0,0,1,0,0,0,0,0,0,0,91861
105645,"MOBILUBE HD PLUS 85W -140, 4LTS",0,0,0,0,0,0,0,2,0,0,0,0,0,0,0,132050
105742,"MOBILGEAR XMP 220, 208LT",0,0,0,0,0,0,0,1,0,0,0,0,0,0,0,787960
105746,"MOBILGEAR XMP 150, 19LTS",0,0,1,0,0,0,1,7,0,0,78752,0,0,0,78752,649706
105747,"MOBILGEAR XMP 220, 19LT",0,2,0,0,0,0,2,10,0,160612,0,0,0,0,160612,936900.4
105748,"MOBILGEAR XMP 460, 19LTS",0,0,1,0,0,0,1,4,0,0,81370,0,0,0,81370,376339
105757,"MOBILGEAR XMP 680, 19LT",1,0,0,0,0,0,1,1,92990,0,0,0,0,0,92990,92990
105825,"MOBIL SUPER 3000 XE4 5W 30, 4LTS",7,4,4,5,3,0,23,34,861746,501216,501216,626520,375912,0,2866610,4244954
105825U,MOBIL SUPER 3000 XE4 5W 30 1X4LT,0,0,0,2,0,0,2,4,0,0,0,63866,0,0,63866,126518
105855,MOBIL SUPER 1000 10W-30 1LT,1,0,0,0,0,0,1,3,67586,0,0,0,0,0,67586,202758
105856,MOBIL SUPER 1000 10W-30 19LT,0,0,1,0,0,0,1,2,0,0,99656,0,0,0,99656,205388
105861,"MOBIL DTE 24 ULTRA, 19LT",0,0,0,0,0,0,0,1,0,0,0,0,0,0,0,82126
105862,"MOBIL DTE 24 ULTRA, 208LT",2,1,2,0,0,0,5,8,1366144,622479,1244958,0,0,0,3233581,5382630
105871,"MOBIL DTE 25 ULTRA, 19LT",3,0,8,0,0,0,11,19,222393,0,520728,0,0,0,743121,1372329
105872,"MOBIL DTE 25 ULTRA, 208LT",0,5,0,0,0,0,5,7,0,2975000,0,0,0,0,2975000,4339480
105875,"MOBIL DTE 26 ULTRA, 208LT",0,0,0,0,0,0,0,2,0,0,0,0,0,0,0,1369426
105876,"MOBIL DTE 27 ULTRA, 1040LT",0,0,0,0,0,0,0,3,0,0,0,0,0,0,0,10554576
105964,"MOBIL 1 ESP 5W 30 F1, 19LT",0,0,0,0,1,0,1,1,0,0,0,0,231238,0,231238,231238
105965,"MOBIL 1 ESP 5W 30, 4LT ",0,0,1,0,0,0,1,2,0,0,165769,0,0,0,165769,331538
110515,"TOTAL CARTER SY 320, 20LT",0,0,0,0,0,0,0,1,0,0,0,0,0,0,0,290000
112534,"TOTAL CARTER EP 680, 20LT",1,0,0,0,0,0,1,24,97180,0,0,0,0,0,97180,2332320
112537,"TOTAL CARTER SH 150, 20 LTS ",0,5,0,0,0,0,5,5,0,1061550,0,0,0,0,1061550,1061550
112538,"TOTAL CARTER SH 320, 208LT ",0,0,0,1,0,0,1,1,0,0,0,1905881,0,0,1905881,1905881
112539,"TOTAL CARTER SH 320, 20LT ",7,0,6,0,0,0,13,18,1751323,0,1501134,0,0,0,3252457,4503402
112550,TOTAL CARTER SH 460 20 LT,0,0,0,0,0,0,0,2,0,0,0,0,0,0,0,500378
112591,"TOTAL DACNIS SH 46, 20LT",0,0,0,1,0,0,1,7,0,0,0,192286,0,0,192286,1346002
112592,TOTAL DACNIS SH 32.20LT,0,0,4,0,0,0,4,5,0,0,834284,0,0,0,834284,1042855
112594,"TOTAL DACNIS SH 68, 20LT ",0,0,0,0,5,0,5,6,0,0,0,0,961430,0,961430,1153716
112718,"TOTAL CARTER SH 220, 20LT ",0,0,0,0,0,0,0,2,0,0,0,0,0,0,0,424620
112753,"TOTAL DROSERA HXE 68, 20LT ",3,0,3,0,3,0,9,14,298491,0,298491,0,298491,0,895473,1392951
127572,"TOTAL NEVASTANE SL 320, 5GAL ",0,0,0,0,0,0,0,1,0,0,0,0,0,0,0,282857
140190,"TOTAL ALTIS EM 2, 18KG",0,0,0,0,0,0,0,4,0,0,0,0,0,0,0,561292
161211,"TOTAL RUBIA TIR 7400 15W-40, 208LT ",0,3,3,5,8,1,20,35,0,1586376,1548750,2581250,4067750,520250,10304376,18583640
161212,"TOTAL RUBIA TIR 7400 15W-40, 20LT",4,5,17,5,6,-3,34,52,244358,300000,1020000,300000,360000,-180000,2044358,3229762
161222,"TOTAL AZOLLA ZS 46, 208LT ",1,0,2,2,0,1,6,17,546000,0,1035000,1035000,0,593640,3209640,9215640
161223,"TOTAL AZOLLA ZS 46, 20LT ",0,5,3,1,18,1,28,63,0,277855,166713,55580,987102,54622,1541872,3588868
161226,"TOTAL AZOLLA ZS 68 , 208LT ",0,0,0,1,1,0,2,8,0,0,0,495000,495000,0,990000,4326000
161227,"TOTAL AZOLLA ZS 68, 20LT ",4,7,3,5,8,1,28,60,227428,382583,162858,271430,434288,54622,1533209,3352033
161350,"TOTAL RUBIA S 30, 20LT ",0,0,0,0,0,0,0,1,0,0,0,0,0,0,0,64600
161356,"TOTAL RUBIA S 50, 20LT ",0,0,0,0,0,0,0,1,0,0,0,0,0,0,0,74757
161407,"TOTAL RUBIA TIR 7900 FE 10W-30 , 20LT",0,0,0,0,0,0,0,0,0,0,0,0,0,0,0,0
162120,"TOTAL DACNIS 46, 20LT",5,0,8,1,5,0,19,22,356295,0,570072,71259,356295,0,1353921,1567698
162125,"TOTAL DACNIS 100, 20LT ",0,0,1,2,0,0,3,6,0,0,103994,207988,0,0,311982,623751
163287,"TOTAL RUBIA 4400  20W/50 , 208LT  TOT CL",0,0,0,0,0,0,0,2,0,0,0,0,0,0,0,1137500
163288,"TOTAL RUBIA 4400 20W - 50, 20LTS",0,0,0,2,0,0,2,7,0,0,0,137772,0,0,137772,482202
164787,"TOTAL FLUIDE II D, 20L",0,0,0,1,0,0,1,1,0,0,0,76716,0,0,76716,76716
170669,"TOTAL, MULTIS COMPEX SHD 100, 17KG  TOTC",1,0,0,0,0,0,1,1,245714,0,0,0,0,0,245714,245714
170853,"TOTAL EQUIVIS ZS 46, 208LT ",0,0,0,0,2,0,2,5,0,0,0,0,1222250,0,1222250,3055625
170854,"TOTAL EQUIVIS ZS 46, 20LT ",1,2,0,0,0,0,3,3,73286,146572,0,0,0,0,219858,219858
170860,"TOTAL EQUIVIS ZS 68, 20LT ",0,0,0,0,0,0,0,10,0,0,0,0,0,0,0,732860
177040,"TOTAL CERAN XM 220, 18KG",1,0,2,0,4,0,7,15,230571,0,461142,0,942284,0,1633997,3500096
178456,"TOTAL CARTER EP 150, 208LT ",6,0,3,0,3,0,12,33,4016064,0,2008032,0,2008032,0,8032128,22016592
178457,"TOTAL CARTER EP 150, 20LT ",0,6,1,0,1,1,9,21,0,414000,69000,0,69000,69000,621000,1536756
178458,"TOTAL CARTER EP 220, 208LT ",0,0,0,0,0,0,0,2,0,0,0,0,0,0,0,1260000
178459,"TOTAL CARTER EP 220, 20LT ",0,3,0,10,3,1,17,21,0,207000,0,690000,207000,69000,1173000,1478252
178511,"TOTAL CARTER EP 320, 20LT ",2,0,0,0,1,0,3,7,170286,0,0,0,85143,0,255429,596001
178513,"TOTAL CARTER EP 460, 20LT",1,0,0,1,0,0,2,8,88286,0,0,88286,0,0,176572,706288
190326,"TOTAL SERIOLA ETA 32, 208LT",2,1,1,1,1,0,6,13,1114250,556302,557125,557125,557125,0,3341927,7241802
190327,"TOTAL SERIOLA ETA 32, 20LT",5,2,1,3,1,1,13,18,294285,117714,58857,176571,58857,60000,766284,1060569
190578,"TOTAL NEVASTANE EP 220, 20LT",0,0,0,0,1,0,1,2,0,0,0,0,186730,0,186730,373460
190581,"TOTAL NEVASTANE EP 320, 20LT",0,0,1,0,0,0,1,1,0,0,215733,0,0,0,215733,215733
190873,"MOLYKOTE G-N PLUS, 1 KG",1,0,0,0,0,0,1,1,70000,0,0,0,0,0,70000,70000
194023,"TOTAL MULTIS EP 2, 180KL",0,0,0,0,0,0,0,1,0,0,0,0,0,0,0,676250
194024,"TOTAL MULTIS EP 2, 18KG",0,0,0,0,0,0,0,1,0,0,0,0,0,0,0,80000
195722,"TOTAL RUBIA WORKS  1000 15W 40, 208LT",1,0,0,0,0,0,1,6,553876,0,0,0,0,0,553876,3323504
197675,"TOTAL RUBIA FLEET HD 400 20W 50, 208LT ",1,0,0,0,0,0,1,1,568750,0,0,0,0,0,568750,568750
197677,"TOTAL RUBIA FLEET HD 400 20W 50, 20LT ",0,0,0,0,1,0,1,1,0,0,0,0,68886,0,68886,68886
200126,MOLYCOTE PASTA 1000 (LATA 1kG),10,0,0,0,0,0,10,10,742860,0,0,0,0,0,742860,742860
204004,"TOTAL TRANS AXLE 7 80W-90, 20LT",0,0,0,1,0,0,1,6,0,0,0,71857,0,0,71857,431142
209911,"TOTAL RUBIA OPTIMA 1100 15W-40, 20LT ",2,2,0,0,2,0,6,6,149714,149714,0,0,149714,0,449142,449142
210536,"TOTAL PNEUMA 100, 208LT ",0,0,0,0,1,0,1,1,0,0,0,0,605820,0,605820,605820
210537,"TOTAL PNEUMA 100, 20LT",5,4,1,0,4,0,14,30,350285,280228,70057,0,280228,0,980798,2101710
210747,"TOTAL DYNATRANS ACX 10W, 20LT",0,0,0,2,0,0,2,5,0,0,0,138914,0,0,138914,347285
218553,"TOTAL RUBIA SX 10W, 20LTS",0,0,0,0,0,0,0,2,0,0,0,0,0,0,0,123858
218557,"TOTAL RUBIA SX 30, 20LT",1,0,1,0,0,0,2,7,68000,0,64600,0,0,0,132600,461880
218923,"TOTAL HYDRAULIC AW 68, 208LT ",4,2,0,4,0,0,10,29,1500000,735504,0,1380000,0,0,3615504,11100504
218924,"TOTAL HYDRAULIC AW 68, 20LT",7,10,13,4,18,0,52,52,280658,405940,521222,155282,630000,0,1993102,1993102
218928,"TOTAL HYDRAULIC AW 46, 20LT",0,5,7,11,2,0,25,25,0,217600,304640,478720,87040,0,1088000,1088000
227131,"TOTAL COOLTECH SUPRAPERF -37C, 20LT",0,0,0,0,1,0,1,5,0,0,0,0,61429,0,61429,308929
227475,"TOTAL MULTIS EP 2, 18KG",1,1,0,1,0,0,3,3,97820,97820,0,97820,0,0,293460,293460
4002,WD-40 SPECIALIST GRASA LITHIO BLANCA 311GR,0,0,0,0,0,0,0,1,0,0,0,0,0,0,0,108000
4006,"BLUE WORKS SILICONA,311 GR",0,6,0,0,0,0,6,9,0,30000,0,0,0,0,30000,45000
4200766,"GRASA LUBRAX LITH PLUS EP 2 ,20KG",0,0,0,0,5,0,5,5,0,0,0,0,540000,0,540000,540000
4201063,"ACEITE LUBRAX TECNO 10W-40 ,19LT",0,0,0,0,0,0,0,4,0,0,0,0,0,0,0,457016
4201064,"ACEITE LUBRAX, TECNO 10W-40 ,208LT",2,1,0,2,1,1,7,12,1342592,671296,0,1342592,691435,691435,4739350,8343936
4201079,"ACEITE LUBRAX UNITRACTOR, 208LT",1,1,0,1,0,0,3,9,559134,559134,0,559134,0,0,1677402,5228160
4201080,"ACEITE LUBRAX TOP TURBO 15W-40 ,208LT",0,0,0,0,0,0,0,5,0,0,0,0,0,0,0,2812000
4201086,"ACEITE LUBRAX EXTRA TURBO 20W-50, 19LT",4,2,0,17,5,3,31,50,232146,113664,0,932992,287570,176074,1742446,2852462
4201093,"ACEITE LUBRAX GL 5 80W-90, 208LT",0,0,0,1,0,1,2,3,0,0,0,584406,0,601938,1186344,1826566
4201115,"ACEITE LUBRAX TURBO VIGOROS 25W-60, 208 LT",0,1,0,0,0,0,1,1,0,596487,0,0,0,0,596487,596487
4201134,"ACEITE LUBRAX TOP TURBO 15W-40, 19LT",1,2,7,1,1,0,12,30,60135,120270,407535,59800,61940,0,709680,1827640
4201138,"ACEITE LUBRAX GL-5 80W-90, 19LT",2,0,2,7,0,3,14,17,133969,0,125818,450818,0,195000,905605,1126822
4201152,"ACEITE LUBRAX GL 5  85W-140, 19LT",0,1,0,1,0,0,2,5,0,69686,0,69686,0,0,139372,366784
4201251,"LUBRAX ADBLUE FLUA SOLUC, 10LT",0,3,14,0,50,0,67,67,0,35787,167006,0,614350,0,817143,817143
4201254,"LUBRAX ADBLUE FLUA SOLUC, 208LT",0,0,1,0,0,0,1,2,0,0,209202,0,0,0,209202,397765
4201593,"ACEITE LUBRAX ATF TDX, 19LT",1,2,2,1,1,2,9,28,59561,119122,122000,59561,61348,122696,544288,1761663
4201594,"ACEITE LUBRAX ATF TDX, 208LT",1,0,0,1,0,0,2,8,552340,0,0,552340,0,0,1104680,4542932
4201620,"ACEITE LUBRAX ESS SL 15W-40, 19LT ",0,0,0,2,0,0,2,2,0,0,0,126428,0,0,126428,126428
4201627,"ACEITE LUBRAX ESS SL 20W-50, 19LTS",1,0,0,0,0,0,1,1,61321,0,0,0,0,0,61321,61321
4201632,"ACEITE LUBRAX UTILE PE, T 208LT",0,2,0,1,2,0,5,24,0,1375696,0,687848,1416940,0,3480484,19072296
4201634,"ACEITE LUBRAX UTILE PE , 19LT",2,9,3,12,4,1,31,60,153664,691488,230832,939666,316548,79137,2411335,4950630
4201635,"ACEITE LUBRAX TECNO 10W-40, 6X4 LT",0,0,0,0,1,0,1,1,0,0,0,0,97000,0,97000,97000
4201635u,"LUBRAX TECNO 10W/40, L4",0,0,0,2,0,0,2,2,0,0,0,50000,0,0,50000,50000
4201638,"ACEITE LUBRAX TURBO 30, 19LT",0,0,0,0,0,0,0,2,0,0,0,0,0,0,0,136352
4201644,"ACEITE LUBRAX VALORA 5W-30, 6X4 LT",1,0,0,0,3,0,4,4,135694,0,0,0,419292,0,554986,554986
4201644u,"ACEITE LUBRAX VALORA 5W-30, BIDON 4 LTS",0,2,0,3,2,0,7,7,0,46000,0,67848,46588,0,160436,160436
4201647,"ACEITE LUBRAX, UTILE OT 46 ,  208LT",1,0,0,0,0,0,1,6,472379,0,0,0,0,0,472379,3256312
4201651,"ACEITE LUBRAX GEAR 150, 19LT",1,1,3,1,4,0,10,20,53468,53468,160404,55070,215476,0,537886,1200496
4201652,"ACEITE LUBRAX GEAR 150, 208LT",1,0,0,0,0,0,1,2,493978,0,0,0,0,0,493978,1097136
4201653,"ACEITE LUBRAX GEAR 220, 19LT",4,3,9,2,6,5,29,42,224760,168570,505710,114190,348000,295000,1656230,2520306
4201654,"ACEITE LUBRAX GEAR 220 ,208LT",0,0,0,0,0,0,0,1,0,0,0,0,0,0,0,520046
4201655,"ACEITE LUBRAX GEAR 320,19LT",2,3,5,4,1,5,20,32,114974,172461,287091,229948,57487,296060,1158021,1878848
4201656,"ACEITE LUBRAX GEAR 320,208LTS",1,0,0,0,0,0,1,17,532477,0,0,0,0,0,532477,9698564
4201678,"REFRIG LUBRAX P/RAD HD-2, 19 LT",0,0,0,0,0,0,0,2,0,0,0,0,0,0,0,107444
4201748,"ACEITE LUBRAX GL -4 80W-90, 19LT",1,0,0,0,0,0,1,6,62113,0,0,0,0,0,62113,379749
4201752,LUBRAX ADBLUE FLUA .20LT,0,0,3,3,2,0,8,17,0,0,65391,65391,45000,0,175782,551750
4201760,"ACEITE LUBRAX GRANS TAC-4 30, 19LT",0,0,0,1,3,0,4,4,0,0,0,63903,197460,0,261363,261363
4201766,"ACEITE LUBRAX HYDRA 32,19LT",0,0,0,0,0,8,8,8,0,0,0,0,0,296059,296059,296059
4201771,"ACEITE LUBRAX HYDRA 46, 208LT",4,5,2,7,5,1,24,26,1452000,1832672,690000,2415000,1725000,355000,8469672,9209672
4201773,"ACEITE LUBRAX HYDRA 46,19LT",0,0,0,0,9,1,10,10,0,0,0,0,315000,35000,350000,350000
4201774,"ACEITE LUBRAX HYDRA 68,19LT",0,0,0,0,1,1,2,2,0,0,0,0,35000,37000,72000,72000
4201783,"ACEITE LUBRAX HYDRA 68, 208LT",7,0,5,3,7,0,22,30,2549795,0,1695000,1013000,2415000,0,7672795,10640795
4201787,"ACEITE LUBRAX HYDRA HV 32, 19 LT",0,0,0,1,0,0,1,2,0,0,0,53657,0,0,53657,118646
4201789,"ACEITE LUBRAX HYDRA HV 46, T 208LT",0,1,1,1,0,0,3,3,0,504853,504853,519999,0,0,1529705,1529705
4201801,"ACEITE LUBRAX HYDRA XP 100, 19LT",6,1,0,0,0,0,7,11,316770,52795,0,0,0,0,369565,588566
4201804,"ACEITE LUBRAX HYDRA XP 32, 19LT",3,2,1,9,11,0,26,43,151194,100796,50398,331795,401910,0,1036093,1944929
4201805,"ACEITE LUBRAX HYDRA XP 32, 208LT",0,0,0,0,1,0,1,1,0,0,0,0,478492,0,478492,478492
4201806,"ACEITE LUBRAX HYDRA XP 46 , 208LT",2,1,1,8,0,0,12,12,829896,414948,414948,3332033,0,0,4991825,4991825
4201807,"ACEITE LUBRAX HYDRA XP 46, 19LT",0,0,0,13,8,0,21,32,0,0,0,485951,280000,0,765951,1355801
4201808,"ACEITE LUBRAX HYDRA XP 68, 19LT",1,6,1,23,2,0,33,40,52000,312144,52024,826043,70000,0,1312211,1711211
4201809,"ACEITE LUBRAX HYDRA XP 68, 208LT",1,0,0,2,0,0,3,6,421392,0,0,842784,0,0,1264176,2657980
4201813,"ACEITE LUBRAX UNITRACTOR, 19LT",2,2,2,2,0,0,8,19,113266,113266,113266,113266,0,0,453064,1236341
4201824,"ACEITE LUBRAX TURBO 20W , 208LT",0,0,0,2,0,0,2,2,0,0,0,954340,0,0,954340,954340
4201837,"GRASA LUBRAX AUTOLITH 2,  6X2.5KG",1,0,2,1,2,0,6,10,69865,0,139730,69865,143920,0,423380,703016
4201838,"GRASA LUBRAX  AUTOLITH 2, 16KG",0,0,3,6,1,0,10,19,0,0,208365,418813,71539,0,698717,1326709
4201839,"GRASA LUBRAX AUTOLITH 2, 181KG",0,0,0,0,0,0,0,2,0,0,0,0,0,0,0,1272581
4201840,"GRASA LUBRAX AUTOLITH 2,  12X0.5KG",1,3,1,1,1,0,7,17,31144,93432,31144,31144,32078,0,218942,558306
4201842,"GRASA LUBRAX  LITH EP 2, 16 KG.",8,4,4,8,10,0,34,47,596888,298296,298444,599127,766859,0,2559614,3561392
4201855,"LUBRAX ADBLUE FLUA , 1000LT ",0,1,0,1,1,0,3,4,0,750000,0,796392,815000,0,2361392,3111392
4201945,"ACEITE LUBRAX GL-5 LS 80W-90,B 19LT",0,0,0,0,0,0,0,1,0,0,0,0,0,0,0,94598
4202060,"ACEITE ESMAX SYNTHETIC C3 5W-30, 208LT ",1,1,0,2,5,0,9,11,759021,759021,0,1478000,3689791,0,6685833,8358604
4202068,"ACEITE LUBRAX TOP TURBO PRO 15W-40, 19LT",0,0,0,0,0,0,0,0,0,0,0,0,0,0,0,0
4202069,"ACEITE LUBRAX TOP TURBO PRO 15W-40, 208LT",1,0,0,0,0,0,1,2,662929,0,0,0,0,0,662929,1322929
4202161,"ACEITE CHEVRON HYDRAULIC OIL AW 46, 18,9LTS",0,0,0,0,0,0,0,29,0,0,0,0,0,0,0,1420740
4202162,"ACEITE CHEVRON HYDRAULIC OIL  AW 68, 208LTS",1,1,1,1,3,0,7,16,375000,375000,345000,345000,1045000,0,2485000,6076000
4202163,"ACEITE CHEVRON HYDRAULIC OIL AW 68, 18,9LTS",0,0,2,0,0,0,2,78,0,0,80188,0,0,0,80188,3812927
4202351,"ACEITE CHEVRON MEROPA 220, 15.9KL (18LTS)",0,0,0,0,0,0,0,8,0,0,0,0,0,0,0,520000
4202353,"ACEITE CHEVRON MEROPA 320, 15.9KL (18LTS)",0,0,0,0,0,0,0,4,0,0,0,0,0,0,0,260000
4202355,"ACEITE CHEVRON MEROPA 460, 15.9KL (18LTS)",0,0,0,0,0,0,0,2,0,0,0,0,0,0,0,129706
4202900U,"LIMPIA PARABRISAS ESMAX, 0.9LTS ",0,0,1,0,0,0,1,1,0,0,1000,0,0,0,1000,1000
4202914,"ACEITE CHEVRON DELO 400 SDE NAC 15W 40, 208LT",0,0,0,0,0,3,3,3,0,0,0,0,0,2213967,2213967,2213967
51384LUB,"CEPSA XTAR 5W-30 ECO C2 C3, 208LT",0,0,0,0,0,0,0,3,0,0,0,0,0,0,0,2437500
51388LUB,"CEPSA XTAR 5W 30 ECO C2 C3 , 208LT",0,0,0,0,0,0,0,2,0,0,0,0,0,0,0,1715000
9054159956c,Rhenus OGT 54 400ML,0,0,1,20,0,0,21,21,0,0,145475,245800,0,0,391275,391275
958562,"SHELL OMALA S2 G 220, 209LT ",0,0,0,1,0,0,1,3,0,0,0,860244,0,0,860244,2602510
958567,"SHELL OMALA S2 G 150, 20LT ",0,0,0,0,5,0,5,13,0,0,0,0,485390,0,485390,1286030
958568,"SHELL OMALA S2 G 220, 20LT ",21,2,0,4,0,2,29,82,1991340,215280,0,430560,0,179980,2817160,7876240
958578,"SHELL HEAT TRANSFER OIL S2, 209LT",1,0,0,0,1,0,2,6,1043413,0,0,0,999459,0,2042872,6215797
958635,"SHELL GADUS S2 V100 3, 18KG",1,0,0,0,0,0,1,4,195915,0,0,0,0,0,195915,783660
958644,"SHELL GADUS S2 V220 2, 18KG",1,0,0,1,0,0,2,6,134756,0,0,134756,0,0,269512,808536
958646,"SHELL GADUS S2 V220 2, 12X1KG",1,0,0,0,0,0,1,3,139711,0,0,0,0,0,139711,419133
958652,"SHELL GADUS S2 V220 AD 2, 18KG",1,0,0,0,0,0,1,1,334419,0,0,0,0,0,334419,334419
958666,"SHELL GADUS S3 T220 2, 18KG",0,0,0,0,0,0,0,4,0,0,0,0,0,0,0,3429772
958667,"SHELL GADUS S3 V220 C 2,180KG",0,0,0,1,0,0,1,2,0,0,0,2914763,0,0,2914763,5866421
958682,"SHELL OMALA S2 G 100, 20LT ",1,2,0,1,0,0,4,4,110280,220560,0,110280,0,0,441120,441120
958689,"SHELL OMALA S2 G 320, 20LT ",0,0,0,0,0,0,0,1,0,0,0,0,0,0,0,105120
958693,"SHELL OMALA S2 G 680, 20LT ",1,0,0,0,0,0,1,1,123017,0,0,0,0,0,123017,123017
958752,"SHELL GADUS RAIL S2 TMB GREASE, 18KG",0,0,0,0,2,0,2,2,0,0,0,0,542880,0,542880,542880
958901,"SHELL RIMULA R3 MV 15W-40 CI4, 208,1LT",2,1,0,1,0,0,4,10,1173490,603490,0,603490,0,0,2380470,5934430
958971,"SHELL KRYNEX K5 OAT 50%, 20LT",0,0,10,5,5,0,20,22,0,0,1132500,566250,566250,0,2265000,2516978
958994,"SHELL CORENA S3 R 46, 208,1LT",0,0,0,0,0,0,0,3,0,0,0,0,0,0,0,4485477
958995,"SHELL CORENA S3 R 46, 18,9LT",2,4,0,0,0,0,6,21,313308,626616,0,0,0,0,939924,3289734
959000,"SHELL MORLINA S2 BL 10, 208,1LT ",0,1,0,0,0,0,1,1,0,1191685,0,0,0,0,1191685,1191685
959431,"SHELL RIMULA R4 X 15W-40, 209LT ",0,0,0,0,0,0,0,2,0,0,0,0,0,0,0,1450672
959892,"SHELL OMALA S2 G 220, 1000LT ",0,0,0,0,0,5,5,5,0,0,0,0,0,18709095,18709095,18709095
964314,"SHELL DIALA S4 ZX L , 209LT",0,0,0,0,0,0,0,1,0,0,0,0,0,0,0,1616443
964398,"SHELL AIR TOOL S2 A 32, 20LT",0,0,0,0,0,0,0,2,0,0,0,0,0,0,0,284960
964600,"SHELL RIMULA R5 LE 10W - 40, 3X4 LTS",0,0,0,0,0,0,0,1,0,0,0,0,0,0,0,97371
964629,"SHELL TELLUS  S2 MX 46,18.9LT",10,0,0,0,0,0,10,24,790400,0,0,0,0,0,790400,2055034
964630,"SHELL TELLUS S2 MX 68, 18.9LTS",39,1,0,0,0,0,40,69,3184179,90331,0,0,0,0,3274510,5577961
964632,"SHELL TELLUS S2 VX 46,208LTS",0,0,0,0,0,0,0,1,0,0,0,0,0,0,0,900573
964635,"SHELL TELLUS S2 MX 32, 18.9",0,0,0,0,0,0,0,1,0,0,0,0,0,0,0,94095
964636,"SHELL TELLUS S2 MX 46, 208LT",0,0,0,0,0,0,0,1,0,0,0,0,0,0,0,640000
964637,"SHELL TELLUS S2 MX 68, 208.1LTS",0,0,0,1,0,0,1,1,0,0,0,732304,0,0,732304,732304
964737,"SHELL TELLUS S2 VX 15, 208LT.",0,0,0,1,0,0,1,1,0,0,0,1142989,0,0,1142989,1142989
964740,"SHELL TELLUS S2 V X 46, 18.9",0,0,0,0,0,0,0,1,0,0,0,0,0,0,0,127343
964741,SHELL TELLUS S2 MX22  18.9LT,0,0,0,0,0,0,0,6,0,0,0,0,0,0,0,581295
964743,"SHELL TELLUS S2 VX 32, 18.9 LTS",1,0,6,0,0,0,7,9,127343,0,764058,0,0,0,891401,1146087
964763,"SHELL RIMULA R3 MV 15W-40 CI4, 20LT ",2,0,0,0,0,0,2,2,152800,0,0,0,0,0,152800,152800
964992,"SHELL OMALA S4 GXV 320, 208,1LT",0,0,0,0,0,0,0,4,0,0,0,0,0,0,0,16664000
965407,"SHELL OMALA S4 GXV 220, 18,9LT ",0,0,0,16,0,0,16,17,0,0,0,9920000,0,0,9920000,10616735
965409,"SHELL CORENA S4 R 32, 18,9LT",0,0,0,0,0,0,0,3,0,0,0,0,0,0,0,2280273
965436,"SHELL GADUS S2 OG 85, 190KG",1,0,0,0,0,0,1,1,4922778,0,0,0,0,0,4922778,4922778
967204,"SHELL GADUS S3 V460 D-2 , 18 KLS",0,0,0,0,0,0,0,5,0,0,0,0,0,0,0,2469600
L100008,"MOLYKOTE DC - 111, 18KG",0,0,0,0,0,0,0,1,0,0,0,0,0,0,0,1528571
L100010,"MOLIKOTE DC-111 , LATA 1KG",0,0,0,0,4,0,4,17,0,0,0,0,400000,0,400000,1514282
L100016,MOLYKOTE DC 04 (TUBOS DE 150 GRS),0,0,0,0,0,0,0,2,0,0,0,0,0,0,0,60000
L100030,"MOLYKOTE P - 37, LATA 500GR",0,0,0,0,0,0,0,20,0,0,0,0,0,0,0,1142850
L100054,"MOLYKOTE BR 2 PLUS, 1KG",0,0,0,1,0,0,1,1,0,0,0,23490,0,0,23490,23490
L100059,"MOLYKOTE HSC PLUS, 1KL",0,0,0,0,0,0,0,1,0,0,0,0,0,0,0,121429
OGT54-S,"SPRAY OGT 54 S , 400 ML X 12 UND",0,0,1,0,0,0,1,2,0,0,153000,0,0,0,153000,298714
RMET-JABMEC-005,DESENGRASANTE DE MANOS 5LT,0,0,0,1,0,0,1,1,0,0,0,17000,0,0,17000,17000
RPRO-DC001-005,"PRO EMULSIFICANTE,  5LT",0,0,1,1,2,0,4,4,0,0,31000,31000,31046,0,93046,93046
